1111111111111111
1000101000000001
1000000P000101E1
1111111111111111
