1111
1111
1001
1001
1C01
1001
1001
1E01
1001
1101
1P01
1111
