111111111111111111111111111111111111
1110001111111111111111111000E1111111
1001100000111111111110000C1111111111
101111111011111111111011111111111111
1000000001C00000000000000000000011C1
100C00010111100000011100000001000001
100000010000000000011000000100000001
100000010000000000000000001000000001
1000001111111111111111111111111000011
100000000000000000000C00000000P00001
111111111111111111111111111111111111
