111111111111111111111111111111111111111111111111111111111111
1C00000000000000000000000001C0000000000000000000000000000001
1000000000000000000000000C0100000000000000000000000000000001
100000000000000000000000000100000C00000000000000000000000001
1C00000000000000000000000000000000000000000000000000000000E1
10000000000000000000C000000000000000000000001000000000000001
100000000000000000000000000000000100000000000000000000000001
10000000C000000000000000000100000000000000000000000000000001
10P100000000000000000010000000000000000000000000000000111111
111111111111111111111111111111111111111111111111111111111111
