11111111111111111111111111111111111111111111
111110111111111111111C1111111111000000C01111
11000000000000000C00000C0101111111C111111111
1111100000000000000000000000000C000000000111
10000001111111111111111111111111111111110011
11E00000000000000000000000000000001100000001
100000000000000000000000C0000000000000000001
10000000000000000000C00000000000000000000001
100P000000C000000000000000000000000000000001
100000000000000000000011111111C1111111000101
11011111111111C11111000000001111111111110001
11111111111111111111111111111111111111111111
