11111111111
11111100001
11111100001
111100P0001
111CE000001
11111111111
