111111
100EC1
100C11
11P111
111111
