111111111
1000001C1
110000111
1E00P1001
10C111111
111111111
